XaIpr	Main spoken language Farsi
XaJD5	Main spoken language Italian
XaIps	Main spoken language Kurdish
XaG5v	Main spoken language Gujarati
XaG5p	Main spoken language Arabic
XaKIL	Main spoken language Finnish
XaIpt	Main spoken language Shona
Xacfm	Main spoken language Avaric
XaJD6	Main spoken language German
XaP48	Main spoken language Bulgarian
XaedX	Main spoken language Romany
Xacfn	Main spoken language Avestan
XaG5q	Main spoken language Bengali
XaP49	Main spoken language Romanian
XaedX	Main spoken language Romanes
Xacfo	Main spoken language Bambara
XaJDK	Main spoken language Albanian
XaP9z	Main spoken language Slovak
XaedX	Main spoken language Romani
Xacfp	Main spoken language Bosnian
XaG5r	Main spoken language Cantonese
XaPA2	Main spoken language Ndebele
XaedX	Main spoken language Romsky
Xacfq	Main spoken language Chamorro
XaJDL	Main spoken language Croatian
XaPF7	Main spoken language Oromo
XaedX	Main spoken language Romanesa
Xacfr	Main spoken language Chechen
XaG5s	Main spoken language Czech
XaPF8	Main spoken language Abkhazian
XaJDM	Main spoken language Greek
Xacfs	Main spoken language Church Slavic
XaG5t	Main spoken language English
XaPF9	Main spoken language Afar
XaJDN	Main spoken language Japanese
Xacft	Main spoken language Chuvash
XaG5u	Main spoken language French
XaPFA	Main spoken language Afrikaans
XaJDO	Main spoken language Korean
Xacfu	Main spoken language Cornish
XaG5v	Main spoken language Gujerati
XaPFB	Main spoken language Armenian
XaJDP	Main spoken language Lithuanian
Xacfv	Main spoken language Cree
XaG5w	Main spoken language Hausa
XaPFC	Main spoken language Assamese
XaJDQ	Main spoken language Turkish
Xacfw	Main spoken language Dhivehi
XaG5x	Main spoken language Hindi
XaPFD	Main spoken language Aymara
XaJDR	Main spoken language Ukrainian
Xacfy	Main spoken language Ewe
XaG5z	Main spoken language Kutchi
XaPFF	Main spoken language Azerbaijani
XaJDS	Main spoken language Vietnamese
Xacg0	Main spoken language Western Frisian
XaG60	Main spoken language Mandarin
XaPFG	Main spoken language Bashkir
XaJDL	Main spoken language Croat
Xacg2	Main spoken language Scottish Gaelic
XaG61	Main spoken language Polish
XaPFH	Main spoken language Basque
XaJOq	Main spoken language Akan
Xacg3	Main spoken language Manx
XaG62	Main spoken language Portuguese
XaPFI	Main spoken language Dzongkha
XaJOr	Main spoken language Amharic
Xacg5	Main spoken language Haitian
XaG63	Main spoken language Punjabi
XaPFK	Main spoken language Bihari
XaJOs	Main spoken language Brawa
XackP	Main spoken language Herero
XaG64	Main spoken language Russian
XaPFL	Main spoken language Bislama
XaJOt	Main spoken language Dutch
XackQ	Main spoken language Hiri Motu
XaG65	Main spoken language Somali
XaPFM	Main spoken language Breton
XaJOu	Main spoken language Ethiopian
XackR	Main spoken language Ido
XaG66	Main spoken language Spanish
XaPFN	Main spoken language Burmese
XaJOv	Main spoken language Flemish
XackS	Main spoken language Sichuan Yi
XaG67	Main spoken language Swahili
XaPFO	Main spoken language Belarusian
XaJOw	Main spoken language French Creole
XackT	Main spoken language Kanuri
XaG68	Main spoken language Sylheti
XaPFP	Main spoken language Central Khmer
XaJOx	Main spoken language Gaelic
XackU	Main spoken language Komi
XaG69	Main spoken language Tamil
XaPFQ	Main spoken language Catalan
XaJOy	Main spoken language Hakka
XackV	Main spoken language Kongo
XaG6A	Main spoken language Urdu
XaPFT	Main spoken language Corsican
XaJOz	Main spoken language Hebrew
XackW	Main spoken language Kuanyama
XaG6B	Main spoken language Yoruba
XaPFU	Main spoken language Danish
XaJP0	Main spoken language Igbo
XackX	Main spoken language Latin
XaQHz	Main spoken language Filipino
XaPFV	Main spoken language Esperanto
XaJP1	Main spoken language Lingala
XackY	Main spoken language Limburgan
XaQht	Main spoken language Hindko
XaPFW	Main spoken language Estonian
XaJP2	Main spoken language Luganda
XackZ	Main spoken language Luxembourgish
XaRAe	Main spoken language Bamun
XaPFX	Main spoken language Faeroese
XaJP3	Main spoken language Malayalam
Xacka	Main spoken language Luba-Katanga
XaRAe	Main spoken language Bamoun
XaPFZ	Main spoken language Fijian
XaJP4	Main spoken language Norwegian
Xackc	Main spoken language Marshallese
XaWQU	Main spoken language Kikuyu
XaPFc	Main spoken language Frisian
XaJP5	Main spoken language Pashto
Xacke	Main spoken language Navajo
XaWQV	Main spoken language Fulani
XaPFd	Main spoken language Galician
XaJP6	Main spoken language Patois
Xackf	Main spoken language South Ndebele
XaWQW	Main spoken language Nyanja
XaPFe	Main spoken language Georgian
XaJP7	Main spoken language Serbian
Xackg	Main spoken language North Ndebele
XaWQW	Main spoken language Chewa
XaPFf	Main spoken language Greenlandic
XaJP8	Main spoken language Sinhala
Xackh	Main spoken language Ndonga
XaX3X	Main spoken language Tetum
XaPFg	Main spoken language Guarani
XaJP9	Main spoken language Swedish
Xackj	Main spoken language Norwegian Nynorsk
XaX3Z	Main spoken language Konkani
XaPFh	Main spoken language Hungarian
XaJPA	Main spoken language Tagalog
Xackk	Main spoken language Norwegian Bokmal
XaX4p	Main spoken language Dari
XaPFi	Main spoken language Icelandic
XaJPB	Main spoken language Thai
Xackm	Main spoken language Ojibwa
XaYWG	Main spoken language Aragonese
XaPFj	Main spoken language Indonesian
XaJPC	Main spoken language Tigrinya
Xacko	Main spoken language Ossetian
XaJPD	Main spoken language Welsh
XaPFk	Main spoken language Interlingua
Xackq	Main spoken language Pali
XaPFl	Main spoken language Interlingue
Xackr	Main spoken language Pushto
XaPFm	Main spoken language Inupiaq
Xacks	Main spoken language Sanskrit
XaPFn	Main spoken language Inuktitut
Xackt	Main spoken language Northern Sami
XaPFo	Main spoken language Irish
Xacku	Main spoken language Sardinian
XaPFp	Main spoken language Javanese
Xackw	Main spoken language Tahitian
XaPFq	Main spoken language Kannada
Xacky	Main spoken language Venda
XaPFr	Main spoken language Kashmiri
Xackz	Main spoken language Volapuk
XaPFs	Main spoken language Kazakh
Xacl0	Main spoken language Walloon
XaPFt	Main spoken language Kinyarwanda
Xacl1	Main spoken language Chinese
XaPFu	Main spoken language Kirghiz
XaPF8	Main spoken language Abkhaz
XaPFv	Main spoken language Rundi
XaPFw	Main spoken language Lao
XaPFy	Main spoken language Latvian
XaPFz	Main spoken language Macedonian
XaPG0	Main spoken language Malagasy
XaPG1	Main spoken language Malay
XaPG2	Main spoken language Maltese
Xacke	Main spoken language Navaho
XaPG3	Main spoken language Maori
Xacfs	Main spoken language Church Slavonic
XaPG4	Main spoken language Marathi
XackS	Main spoken language Nuosu
XaPG5	Main spoken language Moldavian
XaJP2	Main spoken language Ganda
XaPG6	Main spoken language Mongolian
XaPG7	Main spoken language Nauru
XaPG8	Main spoken language Nepali
XaPG9	Main spoken language Occitan
XaPGA	Main spoken language Oriya
XaIpr	Main spoken language Persian
XaPGC	Main spoken language Quechua
XaPGD	Main spoken language Romansh
XaPGE	Main spoken language Samoan
XaPGF	Main spoken language Sango
XaJDL	Main spoken language Serbo-Croatian
XaJP7	Main spoken language Serbo-Croatian
XaPGI	Main spoken language Southern Sotho
XaPGJ	Main spoken language Tswana
XaPGK	Main spoken language Sindhi
XaPGM	Main spoken language Swati
XaPGN	Main spoken language Slovenian
XaPGO	Main spoken language Sundanese
XaPGP	Main spoken language Tajik
XaPGQ	Main spoken language Tatar
XaPGR	Main spoken language Telugu
XaPGS	Main spoken language Tibetan
XaPGT	Main spoken language Tongan
XaPGU	Main spoken language Tsonga
XaPGV	Main spoken language Turkmen
XaPGW	Main spoken language Twi
XaPGX	Main spoken language Uighur
XaPGY	Main spoken language Uzbek
XaPGa	Main spoken language Wolof
XaPGb	Main spoken language Xhosa
XaPGc	Main spoken language Yiddish
XaPGd	Main spoken language Zhuang
XaPGe	Main spoken language Zulu
XaJP8	Main spoken language Sinhalese
XaPFf	Main spoken language Kalaallisut
XaG5y	Main spoken language Iban
XaG63	Main spoken language Panjabi
Xad28	Uses sign language
XaILE	Using British sign language
XaJPI	Using Makaton sign language
XaR76	Preferred method of communication: Makaton
XaR7A	Preferred method of communication: British Sign Language